14 11 11 11 11 11 15 08 09 14 11 11 11 11 11 15
29 35 35 35 35 35 30 06 07 29 35 35 35 35 35 30
29 35 35 35 35 35 30 04 05 29 35 35 35 35 35 30
10 03 03 00 01 03 03 03 03 03 03 03 01 00 00 12
10 01 03 03 01 03 03 00 03 01 03 03 03 03 03 12
10 03 03 03 03 03 03 03 00 00 01 03 03 03 03 12
10 00 03 03 03 03 03 03 01 03 00 03 03 01 03 12
10 03 00 00 03 03 00 03 03 00 03 00 03 03 03 12
10 03 01 03 00 00 03 00 03 03 03 03 00 03 00 12
10 01 03 03 03 01 03 03 03 03 03 03 03 01 01 12
10 03 03 00 03 03 03 03 01 01 00 03 03 01 03 12
17 13 13 13 13 13 13 13 13 13 13 13 13 13 13 16