11 06 06 06 06 06 06 06 12 17 17 17 17 17 17 17 17 17 17 17 17 17 17 17 11 06 06 06 06 06 06 06 12 17 17 17 17
05 00 00 00 00 00 00 00 07 11 06 06 06 06 06 06 00 06 06 06 06 06 06 12 05 00 00 00 00 00 00 00 07 17 17 17 17
05 00 00 00 00 00 00 00 00 00 00 00 00 00 00 00 00 00 00 00 00 00 00 00 00 00 00 00 00 00 00 00 07 17 17 17 17
28 10 10 29 00 09 00 00 07 14 08 08 08 08 08 08 08 08 08 08 08 08 08 13 28 10 10 29 00 09 00 00 07 17 17 17 17
05 00 00 09 00 09 00 00 07 17 17 17 17 17 17 17 17 17 17 17 17 17 17 17 05 00 00 09 00 09 00 00 07 17 17 17 17
05 00 00 09 00 30 10 10 27 17 17 17 17 17 17 17 17 17 17 17 17 17 17 17 05 00 00 09 00 30 10 10 27 17 17 17 17
05 00 00 00 00 00 00 00 07 17 17 17 17 17 17 17 17 17 17 17 17 17 17 17 05 00 00 00 00 00 00 00 07 17 17 17 17
28 10 10 29 00 09 00 00 07 17 17 17 17 17 17 17 17 17 17 17 17 17 17 17 28 10 10 29 00 09 00 00 07 17 17 17 17
05 00 00 09 00 09 00 00 07 17 17 17 17 17 17 17 17 17 17 17 17 17 17 17 05 00 00 09 00 09 00 00 07 17 17 17 17
05 00 00 09 00 30 10 10 27 17 17 17 17 17 17 17 17 17 17 17 17 17 17 17 05 00 00 09 00 30 10 10 27 17 17 17 17
05 00 00 00 00 00 00 00 07 17 17 17 17 17 17 17 17 17 17 17 17 17 17 17 05 00 00 00 00 00 00 00 07 17 17 17 17
28 10 10 29 00 09 00 00 07 06 06 06 15 06 06 06 06 06 06 06 15 06 06 06 28 10 10 29 00 09 00 00 07 17 17 17 17
05 00 00 09 00 09 00 00 07 00 00 00 16 00 00 00 00 00 00 00 16 00 00 00 05 00 00 09 00 09 00 00 07 17 17 17 17
05 00 00 09 00 30 10 10 27 00 00 00 16 00 00 00 00 00 00 00 16 00 00 00 05 00 00 09 00 30 10 10 27 17 17 17 17
05 00 00 00 00 00 00 00 07 00 00 00 16 00 00 00 00 00 00 00 16 00 00 00 05 00 00 00 00 00 00 00 07 17 17 17 17
05 00 00 00 00 00 00 00 07 00 00 00 16 00 00 00 00 00 00 00 16 00 00 00 05 00 00 00 00 00 00 00 07 06 06 06 12
14 08 08 08 00 08 08 08 13 00 00 00 16 08 08 08 00 08 08 08 16 00 00 00 14 08 08 08 00 08 08 08 13 00 00 00 07
05 00 00 00 00 00 00 00 00 00 00 00 00 00 00 00 00 00 00 00 00 00 00 00 00 00 00 00 00 00 00 00 07 00 00 00 07
05 00 00 00 00 00 00 00 00 00 00 00 00 00 00 00 00 00 00 00 00 00 00 00 00 00 00 00 00 00 00 00 00 00 00 00 07
05 00 00 00 00 00 00 00 00 00 00 00 00 00 00 00 00 00 00 00 00 00 00 00 00 00 00 00 00 00 00 00 07 00 00 00 07
24 26 26 25 00 24 26 26 25 00 00 00 24 26 26 25 18 24 26 26 25 00 00 00 24 26 26 25 00 24 26 26 25 00 00 00 07
22 18 18 23 18 22 18 18 23 00 00 00 22 18 18 18 18 18 18 18 23 00 00 00 22 18 18 23 18 22 18 18 23 08 08 08 13
22 18 18 18 18 18 18 18 23 00 00 00 22 18 18 18 18 18 18 18 23 00 00 00 22 18 18 18 18 18 18 18 23 17 17 17 17
22 18 18 18 18 18 18 18 23 00 00 00 22 18 18 18 18 18 18 18 23 00 00 00 22 18 18 18 18 18 18 18 23 17 17 17 17
22 18 18 18 18 18 18 18 23 00 00 00 22 18 18 18 18 18 18 18 23 00 00 00 22 18 18 18 18 18 18 18 23 17 17 17 17
19 21 21 21 18 21 21 21 20 08 08 08 19 21 21 21 18 21 21 21 20 08 08 08 19 21 21 21 18 21 21 21 20 17 17 17 17
17 17 22 18 18 18 23 17 17 17 17 17 17 17 22 18 18 18 23 17 17 17 17 17 17 17 22 18 18 18 23 17 17 17 17 17 17
17 17 22 18 18 18 23 17 17 17 17 17 17 17 22 18 18 18 23 17 17 17 17 17 17 17 22 18 18 18 23 17 17 17 17 17 17
17 17 22 18 18 18 23 17 17 17 17 17 17 17 22 18 18 18 23 17 17 17 17 17 17 17 22 18 18 18 23 17 17 17 17 17 17
17 17 19 21 21 21 20 17 17 17 17 17 17 17 19 21 21 21 20 17 17 17 17 17 17 17 19 21 21 21 20 17 17 17 17 17 17